# # # # # # # # # # # # # # # # # # # # # # # # # # # # # # # # # # # # # # # #
#                                                                             #
#                                                                             #
#                                                                             #
#                                                                             #
#                                                                             #
#                                                                             #
#                                                                             #          
#                                                                             #
#                                                                             #
#                                                                             #
#                                                                             #          
#                                                                             #
#                                                                             #
#                                                                             #
# # # # # # # # # # # # # # # # # # # # # # # # # # # # # # # # # # # # # # # #
