#######################################
#              #      #    #####      #
#            #####  # #  #      #     #
#             #  #  # #  #   ## #     #
#             #  #  # #  # # ## #     #
#      ######### #  # #### # ## #     #
#      #         #  # #    # ## #     #
#      # ####### #  # # ## #          #
#      #      #  #  # # #  ##### ######
#      #  ##  #  #  #              #  #
#      #   #  #     ############   #  #
#      # E #  #  #  # #            #  #
#      #####  #     # #  # #########  #
#         #   ####### #  #      #     #
#         #           #  #   #     #  #
#####################################S#