######################################## #######################################
#                         #                                                    #
# # #   # # # # # #   #       # # # # # #                                      #
#   #     #                   #         #                                      #
#   #     #       # # # #   # # # # # # # # #   # # # # # #                    #
#   #     # # # # #                     #                 #                    #
#   #                                             #       #                    #
#   #                                   #         #       #                    #
#   # # # # # # # #   # # # # # # # # # # # #     #                            #
#     #           #   #                     #     # # # # #                    #
#         #       #   #   #   #     #   #   #             #                    #
#     # # #   # #     #   #   #     #   #   # # # # #                          #
#     #                   #   #     #   #                 #                    #
#     # # # # # # #     #     #     #   # # # # #         #                    #
#               #       #       #   #           #         #                    #
## ########### ############# ####################### ####### ###################
